Question,1,2,3,4,5,N
PALACE HILLS,15,0,15,0,10,40
NORTHWEST,2,0,5,0,1,8
OLD TOWN,2,0,5,0,2,9
SAFE TOWN,2,0,5,0,1,8
SOUTHWEST,0,0,10,0,5,15
DOWNTOWN,2,0,5,0,1,8
WILSON FOREST,9,0,1,0,0,10
SCENIC VISTA,2,0,5,0,1,8
BROADVIEW,0,0,10,0,5,15
CHAPPARAL,2,0,5,0,1,8
TERRAPIN SPRINGS,2,0,5,0,1,8
PEPPER MILL,6,0,9,0,7,22
CHEDDARFORD,6,0,7,0,9,22
EASTON,2,0,5,0,1,8
WESTON,11,0,1,0,0,12
SOUTHTON,2,0,5,0,1,8
OAK WILLOW,0,0,10,0,5,15
EAST PARTON,6,0,7,0,7,20
WEST PARTON,9,0,1,0,0,10